#################################################################################
#.#.........#........s..#...#...........#.#z..#.........#...#................e..#
#.#.#######.#.###.#####.#.#.#########.#.#.#.#.#.#.#######.#.#.###########.#####.#
#...#.....#.#...#.#...#.#.#.....#.....#.#.#.#.#.#.........#....f#.......#.#.....#
#.#######.#.#.###.#.###.#.#####.#.#####.#.#.#.#.#########.#######.#####.###.###C#
#.#.......#.#.#...#...#...#...#.#...#.#.#...#.R...#.....#.#...#...#.........#...#
#.#.#######.#.#.###.#.#####.#.#.###.#.#.#.#####.###.###.#.#.#.#.#.###########.###
#.#.#.....#...#.#...#.....#.#.#...#.#...#.#...#.#...#...#...#.#.#.#.......#...#.#
#.#.#.###.#.###.#.#####.#.###.###.#.#######.#.###.###.#########.###.#####.#.###.#
#...#.#...#.#...#.#...#.#.....#...#.....#...#...#.#.#u........#j..#.#.#...#.....#
#.###.#.#####.###.###.#.###.###.###.###.#.#####.#.#.#########.#.#P#.#.#.#######.#
#.#...#...#...#.......#.#...#...#.....#.#...#...#x#.....#.....#.#.....#...Y.#...#
#.#.#####.#.###.#######.#.###.#########.###.#.###.#####.#.#####.###########.#.###
#.#...#.....#...#.....#.#.#.#.#.........#...#.#.....#...#..g..#.#.#.........#...#
#####.#######.###.###.#.#.#.#.###.#####.#.###.#####.#.#######.#.#.#.###########.#
#...#.#...#.#.#.#...#...#...#...#.#...#.#...#.....#.#.....#...#...#.Q.....#.....#
#.#.#.#.#.#.#.#.###.#######.###.#.###.#.#.#.#####.#.#.###.#.#########.###.#.#####
#.#.W.#.#.#.#...#...#...#.#.#.#.#...#...#.#.#.......#...#m..........#...#.#.#...#
#.#####.#.#.###.#.###.#.#.#.#.#.###.#.###.#.#######################.###.#.#.###.#
#.#.....#.#.....#.#...#.#.....#.#...#...#.#.#.......#...#.......#...#...#.#.#...#
#.#.#####.#.#####.#.###.#.#####.#.#####.#.#.#.#####.#.#.#.#####.###.#####.#.#.###
#k#.#...#.#...V.#...#.#.#...#...#.#...#.#.#...#...#...#...#...#...#.......#.#...#
#.#.#.###.#####.#####.#.#####.###.#.#.#.#.#####.#.#########.#####.#########.###.#
#.....#.N.#...#...#...#.....#.....#.#...#.#.....#.#...#.....#.....#.....#.......#
#######.#.#.#.###.#.#######.#######.#####.###.###.#.#.#.#####.#.###.###.#.#######
#.......#.#.#.#.#.#...#...#.........#...#.....#...#.#...#.....#.......#.#...#...#
#.###.#####.#.#.#.###.#.#.#######.#####.#######.###.#################.#.#####.#D#
#.#.#.#.....#.#.#...#...#.......#.B...#.#.....#...#.#...............#.#..v..#.#.#
#.#.#.#.#####.#.###.###########.#####.#.###.#.###.#.#####.#########.#.#####.#.#.#
#.#...#.#...#.#.....#.......#...#...#.#.#...#.#...#.#...#.#...#.#...#.....#...#.#
#.#.###.###.#.###.#####.#.###.###.###.#.#.###.#.###.#.#.#.#.#.#.#.#############.#
#.#...#.#...#...#.#...#.#.#...#...#...#.#.#...#.#...#.#...#.#...#.#.......#...#.#
#.#####.#.#####.#.#.#.#.###.###.#.#.###.#.#####.#.###.#####.#####.#.#####.#.#.#.#
#.......#.....#.#...#.#.#...#...#.#...#.#.......#.#.....#.......#...#...#...#.#.#
#.#########.###.#####.#.#.###.###.###.#.#.#######.###.#.#.#####.#####.#.#####.#.#
#...........#...#...#...#...#.#.....#...#.......#...#.#.#.....#...#...#...#...#.#
###########.#.###.#.#.#####.#.#.#######.###########.###.#####.###.#.#.#####.###.#
#...#...#...#.#...#.#.#.....#.#.#.....#.#...........#...#...#...#...#.#...#.#.I.#
#.###.#.#.###.#.###.###.#####.###.#.###.#.###########.###.#####.#####.#.#.#.#.#.#
#.....#.....#.....#.....#.........#....@#@............#.............#...#.....#.#
#################################################################################
#...#d..#.....#.....#.......#.....#.#..@#@............#.............A.#.........#
#.#.###.#.#.###L###.#.#.###.#.###.#.#.#.#.###########.#.#.#############.###.###.#
#.#...#...#...#.#t#.#.#...#a..#...#...#.#.#...#.....#.#.#.....#....l#.....#...#.#
#.###.###.###.#.#.#.#.###.#####.#######.#.#.#.#####.#.#.#####.#.###.#.#######.#.#
#.#.#o..#.#..i#...#...#.#.#.........#...#...#.......#...#...#.#.#.#...#.#.T.#.#.#
#.#.###.#.#.#####.#####.#.#########.#.#.###########.#######.#.#.#.#####.#.#.#.#.#
#.#...#.#.#.....#...#...#.#...#.......#.#...#.......#.......#...#.......#.#...#.#
#.#H###.#######.###.###.#.#.#.#########.###.#.#######.###.#########.###.#.#####.#
#.#.....#.....#.........#...#.....#b....#...#.....#.#.#.#.........#.#...#.....#.#
#.###.###.###.###################.###.###.#######.#.#.#.#######.#.#.#########.###
#...#.....#.#...#...#...........#...#...#...#.....#.#...#.....#.#...#.......#...#
#.#.#######.###.#.#.#.#########.###.#######.#.#####.###.#.#.###.#.###.#####.#.#.#
#.#.#...#...#...#.#...#.......#...#.....#...#...#.....#...#.#...#.#...#...#.#.#.#
#.#.#.#.#.#.#.###.#####.#########.###.#.#.#####.#.#.#######.#.###.#.###.#.#.###.#
#.#.#.#...#.......#.................#.#.#.......#.#.........#...#.#.#.#.#.#...#.#
#.#.#.#########.#########.#########.###.#.#########.###########.#.#.#.#.#.###.#.#
#.#.#.#.......#.#...#...#.#.......#...#.#.#.......#.#...#.......#.#.#.#.#.....#.#
###.#.#.#####.#.#.#.#.#.#.#E#####.###.#.#.#.###.#.#.#.#.#.#########.#.#.#######.#
#...#.#.#...#.#.#.#...#.#.#.#.....#...#.#.#.#...#.#...#.#...#.......#.#.#.....#.#
#.###.#.#.###.#.#.#####.###.#.#####.###.#.#.#.###.#####.###.#.#######.#.###.#.#.#
#.#...#.#...#.#.#.#...#...#.#...#.......#.#.#.#.#.#...#.#...#.#.......#.....#...#
#.###.#.#.#.#.#.#Z#.#####.#.###.#######.#.###.#.#.#.#.#.#.#####.###.#############
#...#.#.#.#.#.#.#...#.#r..#...#...#...#.#.#...#.#.#.#...#.........#.....#.......#
#.#.###.###.#.#.#####.#.#####.###.#.#.#.#.#.###.#.#.###############.###.#.#####.#
#.#.#...#...#.#.#.#...#.F.#...#...#.#.#.#.#...#.#.#.#...#.........#...#.#.#...#.#
#.#.#.###.#.#.#.#.#.#.###.#.###.###.#.###.###.#.#.###.#.#.#######.###.#.#.#.###.#
#.#.#...#.#.#.#...#.#...#...#.#cJ...#...#.....#.#.....#...#.#...#.#...#.#.#...#.#
#.#.###.#.#.#.#####.###.#####.#########.#######.###########.#.#.#.#####.#.###.#.#
#.#...#.#.#.#.......#.#...#.....#..p..#.#.....#...#.....#.....#.#.....#.#...#.#.#
#####.#.#.###########.#.###.#.###.#.###.#.###.#.#.#.###.#.#####.#####.#.###.#K#.#
#.....#.#...#.......U.#.....#.#...#.....#.#.#...#...#.#...#...#.#.S...#.......#.#
#.#.###.###.#.###.###.#######.#.#########.#.#########.#####.#.#.#.#######.#####.#
#.#.#...#...#.#.#.#.#.....#y..#...#.....#...#.........#.....#...#.......#.#...#w#
#.###.###.###.#.#.#.#####.#.#####.#.#.#####.#.###.#####.#####.#########.#.#.#.#.#
#...#...#.....#.#.#.......#.......#.#...#.#.#...#.#.....#.....#.......#.#n#.#.#.#
#.#.###.#.#####.#.#####.###############.#.#.###.#.#.###########.###.###.###.#.#.#
#.#...#.#.......#.....#.#.............M.#.#.#...#.#...#.........#...#..h#...#.O.#
#.#.###.#############.#G###.###########.#.#.#.###.###.#.#########.###.###.#####.#
#.#...............X...#.....#......q....#.....#.....#...........#.........#.....#
#################################################################################